WWWWW####E
W#########
W###W#####
W###W#####
W###W#####
W###W#####
WS##W#####
W#WWW#####
W#WWW#####
WBWWW#####