WWWWW####E
W#########
W###W##S##
W###W#####
WS##W#####
W###W#####
WS##W#####
W#WWW#####
W#WWW#####
WBWWW#####